0000lll0000000
00000000000000
00000000000000
00000000000000
00000000000000
00000000000lll
lll00000000000
00000000000000
00000000000000
00000000000000
00000000000000
00000000000000
00000000000000
0lll0000000000
