0000lll0000000
00000000000000
00000000000000
000lllllllllll
00000000000000
00000000000lll
lllaaaaaaaaaaa
00000000000000
00000000000000
pppppppppppppp
00000000000000
aaaaaaaaaaaaaa
00000000000000
0lll0000000000
