000llllllll000
00000000000000
aaa00000000aaa
00000000000000
00000000000000
lll00000000lll
00000000000000
000pppppppp000
00000000000000
000aaaaaaaa000
00000000000000
00000000000000
00000lll000000
00000l0l000000
