00l00l00l00l00
ll0ll0ll0ll0l0
pppppppppppppp
0a0a0a0a0a0a0a
00000000000000
00000000000000
0l0l0l0l0l0l0l
0l0l0l0l0l0l0l
0l0l0l0l0l0l0l
0l0l0l0l0l0l0l
0l0l0l0l0l0l0l
0l0l0l0l0l0l0l
0l0l0l0l0l0l0l
0l0l0l0l0l0l0l
