00000000000000
00000000000000
bbb00000000bbb
00000000000000
00000000000000
lll00000000lll
00l00000000l00
00lppppppppl00
00l00000000l00
00laaaaaaaal00
00l00000000l00
00l00000000l00
00l00lll000l00
00l00l0l000l00
