00l00l00l00l00
l00ll0ll0ll0l0
pppppppppppppp
0a0a0a0a0a0a0a
0000000000000l
00000000000000
0l0l0l0l0l0l0l
0l0l0l0l0l0l0l
0l0l0l0l0l0l0l
0l0l0l0l0l0l0l
0l0l0l0l0l0l0l
0l0l0l0l0l0l0l
0l0l0l0l0l0l0l
0l0l0l0l0l0l0l
