0a0a0a0l000000
0l0l0l0l000000
l0l0l0l0l0l0l0
0l0l0l0l0l0l0l
0b0b0b0b0b0b0b
p0p0p0p0p0p0p0
p0p0p0p0p0p0p0
p0p0p0p0p0p0p0
p0p0p0p0p0p0p0
p0p0p0p0p0p0p0
p0p0p0p0p0p0p0
p0p0p0p0p0p0p0
p0p0p0p0p0p0p0
p0p0p0p0p0p0p0